#############
# W c F l   #
### ##### ###
# M c r A a #
#############