#############
# W a l l   #
### ##### ###
# M a   a a #
#############